#######################################
#   #    #   #                  #     #
#   #    #   #             #  # #     #
#   #    #   ###############  ###  ####
#   #### #                            #
#        #   ###############  #       #
####     #   #      #      #  #########
#  #         #             #  #       #
#        #   #      #      #          #
#######################################
