########################################
#    #    #   #                  #     #
#    #    #   #                  #     #
#    #    #   ###############  ###     #
#    #### #                            #
#         #   ###############  #       #
#####     #   #      #      #  #########
#         #   #      #      #          #
#         #   #      #      #          #
##### #####   ### ###### ###############
#                                      #
#                                      #
##### #####   ########  ################
#         #   #      #  #     #        #
###  ###  #   #      #  #     #        #
#      #  #   #         #              #
#      #  #   #################   ######
###### #  #                   #   #    #
#    # #  ###############  ####   #    #
#      #                               #
########################################
