####################
#        #         #
#   #    #   #     #
#   #    #         #
#   # ####  ##     #
#                  #
#      #   ### ### #
#      #     #     #
#  #         #     #
#  #   #           #
####################
