####################
#        #         #
#   #    #   ####  #
#   #    #      #  #
#   # ####   ####  #
#               #  #
#  #####   ###     #
#      #     #  ####
#  ###       #  #  #
#  #   #        #  #
####################
