####################
#        #         #
#   #    #   #     #
#    #   #         #
#     #     #      #
#                  #
#      #       ##  #
#      #           #
#            #     #
#  #   #           #
####################
