####################
#        #         #
#        #         #
#        # #########
########           #
#          #########
######## #         #
#        #         #
#        #         #
####################
